èÍèä,ÉtÉ@ÉCÉãñº,åæåÍ,óLå¯çs(á@),ÉRÉÅÉìÉgçs(áA),ãÛîíçs(áB),çáåvçs(á@Å{áAÅ{áB)
C:\Users\hokada\Desktop\NetCommons2-develop\html\webapp\modules\announcement\action\admin\operation,Operation.class.php,PHP,112,33,17,162
C:\Users\hokada\Desktop\NetCommons2-develop\html\webapp\modules\announcement\action\edit\delblock,Delblock.class.php,PHP,29,16,9,54
C:\Users\hokada\Desktop\NetCommons2-develop\html\webapp\modules\announcement\action\edit\init,Init.class.php,PHP,65,18,9,92
C:\Users\hokada\Desktop\NetCommons2-develop\html\webapp\modules\announcement\action\upload\image,Image.class.php,PHP,13,19,6,38
C:\Users\hokada\Desktop\NetCommons2-develop\html\webapp\modules\announcement\action\upload\init,Init.class.php,PHP,13,19,6,38
C:\Users\hokada\Desktop\NetCommons2-develop\html\webapp\modules\announcement\components,View.class.php,PHP,37,30,8,75
C:\Users\hokada\Desktop\NetCommons2-develop\html\webapp\modules\announcement\files\js,announcement.js,JavaScript,50,39,3,92
C:\Users\hokada\Desktop\NetCommons2-develop\html\webapp\modules\announcement\templates\default,announcement_mobile_details.html,HTML,18,1,2,21
C:\Users\hokada\Desktop\NetCommons2-develop\html\webapp\modules\announcement\templates\default,announcement_mobile_details_feature.html,HTML,40,1,8,49
C:\Users\hokada\Desktop\NetCommons2-develop\html\webapp\modules\announcement\templates\default,announcement_mobile_details_smart.html,HTML,14,1,4,19
C:\Users\hokada\Desktop\NetCommons2-develop\html\webapp\modules\announcement\templates\default,announcement_mobile_init.html,HTML,22,1,3,26
C:\Users\hokada\Desktop\NetCommons2-develop\html\webapp\modules\announcement\templates\default,announcement_mobile_nonexistent.html,HTML,13,1,0,14
C:\Users\hokada\Desktop\NetCommons2-develop\html\webapp\modules\announcement\templates\default,announcement_nonexistent.html,HTML,7,1,0,8
C:\Users\hokada\Desktop\NetCommons2-develop\html\webapp\modules\announcement\templates\default,announcement_script.html,HTML,7,1,0,8
C:\Users\hokada\Desktop\NetCommons2-develop\html\webapp\modules\announcement\templates\default,announcement_view_edit_init.html,HTML,31,1,0,32
C:\Users\hokada\Desktop\NetCommons2-develop\html\webapp\modules\announcement\templates\default,announcement_view_main_init.html,HTML,23,1,0,24
C:\Users\hokada\Desktop\NetCommons2-develop\html\webapp\modules\announcement\update,Update.class.php,PHP,24,12,2,38
C:\Users\hokada\Desktop\NetCommons2-develop\html\webapp\modules\announcement\validator,Validator_MobileBlock.class.php,PHP,25,35,6,66
C:\Users\hokada\Desktop\NetCommons2-develop\html\webapp\modules\announcement\view\admin\search,Search.class.php,PHP,57,27,10,94
C:\Users\hokada\Desktop\NetCommons2-develop\html\webapp\modules\announcement\view\edit\init,Init.class.php,PHP,17,13,5,35
C:\Users\hokada\Desktop\NetCommons2-develop\html\webapp\modules\announcement\view\main\init,Init.class.php,PHP,26,13,8,47
C:\Users\hokada\Desktop\NetCommons2-develop\html\webapp\modules\announcement\view\mobile\init,Init.class.php,PHP,12,15,4,31
,,,655,298,110,1063
