èÍèä,ÉtÉ@ÉCÉãñº,åæåÍ,óLå¯çs(á@),ÉRÉÅÉìÉgçs(áA),ãÛîíçs(áB),çáåvçs(á@Å{áAÅ{áB)
C:\Users\hokada\Desktop\Announcements-master\Config\Migration,1402298958_announcements.php,PHP,116,35,9,160
C:\Users\hokada\Desktop\Announcements-master\Config\Migration,1412870771_announcements_language_fix.php,PHP,165,43,11,219
C:\Users\hokada\Desktop\Announcements-master\Config\Migration,1414721765_announcements_add_column.php,PHP,84,43,14,141
C:\Users\hokada\Desktop\Announcements-master\Config\Migration,1415896217_announcements_remove_comment_column.php,PHP,29,32,6,67
C:\Users\hokada\Desktop\Announcements-master\Config\Migration,1417142965_add_language_id_to_announcements.php,PHP,28,19,5,52
C:\Users\hokada\Desktop\Announcements-master\Config\Schema,schema.php,PHP,31,32,7,70
C:\Users\hokada\Desktop\Announcements-master\Controller,AnnouncementsAppController.php,PHP,9,18,4,31
C:\Users\hokada\Desktop\Announcements-master\Controller,AnnouncementsController.php,PHP,133,55,19,207
C:\Users\hokada\Desktop\Announcements-master\Model,Announcement.php,PHP,112,64,23,199
C:\Users\hokada\Desktop\Announcements-master\Model,AnnouncementsAppModel.php,PHP,5,16,4,25
C:\Users\hokada\Desktop\Announcements-master\Test\Case,AllAnnouncementsTest.php,PHP,32,18,3,53
C:\Users\hokada\Desktop\Announcements-master\Test\Case\Controller,AnnouncementsAppTest.php,PHP,90,54,14,158
C:\Users\hokada\Desktop\Announcements-master\Test\Case\Controller,AnnouncementsControllerErrorTest.php,PHP,83,30,17,130
C:\Users\hokada\Desktop\Announcements-master\Test\Case\Controller,AnnouncementsControllerTest.php,PHP,124,47,21,192
C:\Users\hokada\Desktop\Announcements-master\Test\Case\Controller,AnnouncementsControllerValidateErrorTest.php,PHP,144,30,20,194
C:\Users\hokada\Desktop\Announcements-master\Test\Case\Model,AnnouncementAppModelTest.php,PHP,52,39,8,99
C:\Users\hokada\Desktop\Announcements-master\Test\Case\Model,AnnouncementErrorTest.php,PHP,32,28,8,68
C:\Users\hokada\Desktop\Announcements-master\Test\Case\Model,AnnouncementTest.php,PHP,231,48,34,313
C:\Users\hokada\Desktop\Announcements-master\Test\Case\Model,AnnouncementValidateErrorTest.php,PHP,95,28,9,132
C:\Users\hokada\Desktop\Announcements-master\Test\Fixture,AnnouncementFixture.php,PHP,64,19,4,87
C:\Users\hokada\Desktop\Announcements-master\Test\Fixture,BlockFixture.php,PHP,43,22,5,70
C:\Users\hokada\Desktop\Announcements-master\Test\Fixture,CommentFixture.php,PHP,32,22,5,59
C:\Users\hokada\Desktop\Announcements-master\Test\Fixture,FrameFixture.php,PHP,70,22,5,97
C:\Users\hokada\Desktop\Announcements-master\Test\Fixture,PluginFixture.php,PHP,36,22,5,63
C:\Users\hokada\Desktop\Announcements-master\Test\Fixture,UserAttributesUserFixture.php,PHP,33,17,5,55
C:\Users\hokada\Desktop\Announcements-master\Test\Fixture,UserFixture.php,PHP,62,17,5,84
C:\Users\hokada\Desktop\Announcements-master\webroot\js,announcements.js,JavaScript,34,188,29,251
,,,1969,1008,299,3276
